VVVVVVVVVV
VVVVVVVVVV
VCCCCCCCVV
VCEVVVECVV
VCCCVTVCVV
VVVCVVVCCC
VCCCVVVVVV
CCEVVVVVVV
VVVVVVVVVV
VVVVVVVVVV