VVVVVVVVVV
VVVVVVVVVV
VCCCCCCCVV
VCEVVVECVV
VCCCVVVCVV
VVVCVEVCCC
VCCCVVVVVV
CCEVVVVVVV
VVVVVVVVVV
VVVVVVVVVV